2 2 2 2 2 2 2 2 2 2 2 2 2 2 2 2
2 5 5 5 5 5 5 5 5 5 5 5 5 5 5 2
2 5 4 4 0 0 0 0 0 0 0 0 0 0 5 2
2 5 0 0 0 1 1 1 1 1 1 0 0 0 5 2
2 0 0 0 0 1 6 6 6 6 1 2 2 2 2 2
2 0 0 0 0 1 6 6 6 6 1 2 2 2 2 2
2 5 0 0 0 1 1 6 6 1 1 0 0 0 5 2
2 5 0 0 0 0 0 0 0 0 0 0 0 0 5 2
2 5 0 0 0 0 0 0 0 0 0 0 4 4 5 2
2 5 0 0 0 0 0 0 0 0 0 0 4 4 5 2
2 5 5 5 5 5 5 5 5 5 5 5 5 5 5 2
2 2 2 2 2 2 2 2 2 2 2 2 2 2 2 2
